level1.items.txt
level1.obstacles.txt
###########
<.......###
#....&..#
#.......###
#a......@.#
###########