########################
#......b######......####
#.......##c....####B####
#a...@..######.##.....##
#.......A......##....<##
########################