###########
<.......###
#.......#..
#.......###
#.......@.#
###########