########################
#.P....b######......####
#.......##c....####B####
#a...@..######.##...P.##
#P......A......##P...<##
########################