############
#......b####
#.......####
#a...@..####
#.......A..<
############