###########
<.......###
#....&..#
#.....#####
#a......@.#
###########